Erynnis marloyi	Zwartbruin dikkopje
Carcharodus alceae	Kaasjeskruiddikkopje
Carcharodus lavatherae	Andoorndikkopje
Carcharodus floccifera	Pluimdikkopje
Carcharodus orientalis	Oostelijk andoorndikkopje
Carcharodus baeticus	Malrovedikkopje
Carcharodus stauderi	Woestijndikkopje
Spialia phlomidis	Groot windedikkopje
Spialia sertorius	Kalkgraslanddikkopje
Spialia orbifer	Oostelijk kalkgraslanddikkopje
Spialia therapne	Corsicaans kalkgraslanddikkopje
Muschampia proto	Klein brandkruiddikkopje
Muschampia tessellum	Groot brandkruiddikkopje
Muschampia cribrellum	Mozaiekdikkopje
Pyrgus carthami	Witgezoomd spikkeldikkopje
Pyrgus sidae	Geelbandspikkeldikkopje
Pyrgus andromedae	Bergspikkeldikkopje
Pyrgus cacaliae	Donker spikkeldikkopje
Pyrgus centaureae	Noords spikkeldikkopje
Pyrgus malvae	Aardbeivlinder
Pyrgus malvoides	Zuidelijke aardbeivlinder
Pyrgus serratulae	Voorjaarsspikkeldikkopje
Pyrgus onopordi	Aambeeldspikkeldikkopje
Pyrgus carlinae	Westelijk spikkeldikkopje
Pyrgus cirsii	Rood spikkeldikkopje
Pyrgus cinarae	Turks spikkeldikkopje
Pyrgus armoricanus	Bretons spikkeldikkopje
Pyrgus alveus	Groot spikkeldikkopje
Pyrgus bellieri	Frans spikkeldikkopje
Pyrgus warrenensis	Alpenspikkeldikkopje
Heteropterus morpheus	Spiegeldikkopje
Carterocephalus palaemon	Bont dikkopje
Carterocephalus silvicola	Geelbont dikkopje
Thymelicus lineola	Zwartsprietdikkopje
Thymelicus sylvestris	Geelsprietdikkopje
Thymelicus acteon	Dwergdikkopje
Thymelicus hyrax	Turks geelsprietdikkopje
Hesperia comma	Kommavlinder
Ochlodes venata	Groot dikkopje
Gegenes pumilio	Klein kustdikkopje
Gegenes nostrodamus	Groot kustdikkopje
Borbo borbonica	Borbodikkopje
Pelopidas thrax	Gierstdikkopje
Zerynthia rumina	Spaanse pijpbloemvlinder
Zerynthia polyxena	Zuidelijke pijpbloemvlinder
Zerynthia cerisy	Oostelijke pijpbloemvlinder
Zerynthia cretica	Kretapijpbloemvlinder
Archon apollinus	Pijpbloemapollo
Parnassius mnemosyne	Zwarte apollovlinder
Parnassius phoebus	Kleine apollovlinder
Parnassius apollo	Apollovlinder
Iphiclides podalirius	Koningspage
Papilio machaon	Koninginnenpage
Papilio hospiton	Corsicaanse koninginnenpage
Papilio alexanor	Zuidelijke koninginnenpage
Leptidea sinapis	Boswitje
Leptidea duponcheli	Zwartsprietboswitje
Leptidea morsei	Oostelijk boswitje
Anthocharis cardamines	Oranjetipje
Anthocharis euphenoides	Geel oranjetipje
Anthocharis damone	Oostelijk oranjetipje
Anthocharis gruneri	Zwavelig oranjetipje
Zegris eupheme	Zuidelijk oranjetipje
Euchloe belemia	Gestreept marmerwitje
Euchloe crameri	Westelijk marmerwitje
Euchloe simplonia	Bergmarmerwitje
Euchloe ausonia	Oostelijk marmerwitje
Euchloe tagis	Klein marmerwitje
Euchloe insularis	Corsicaans marmerwitje
Euchloe charlonia	Groen marmerwitje
Euchloe penia	Geel marmerwitje
Aporia crataegi	Groot geaderd witje
Pieris brassicae	Groot koolwitje
Pieris krueperi	Schildzaadwitje
Pieris mannii	Scheefbloemwitje
Erynnis tages	Bruin dikkopje
Pieris rapae	Klein koolwitje
Pieris ergane	Wedewitje
Pieris napi	Klein geaderd witje
Pieris bryoniae	Berg geaderd witje
Pieris balcana	Balkan geaderd witje
Pontia callidice	Bergresedawitje
Pontia daplidice	Resedawitje
Pontia chloridice	Klein resedawitje
Colotis evagore	Vals oranjetipje
Colias phicomone	Bergluzernevlinder
Colias nastes	Vale luzernevlinder
Colias palaeno	Veenluzernevlinder
Colias erate	Oostelijke luzernevlinder
Colias croceus	Oranje luzernevlinder
Colias hecla	Noordse luzernevlinder
Colias myrmidone	Bremvlinder
Colias chrysotheme	Steppeluzernevlinder
Colias aurorina	Griekse luzernevlinder
Colias caucasica	Balkanbremvlinder
Colias hyale	Gele luzernevlinder
Colias alfacariensis	Zuidelijke luzernevlinder
Gonepteryx rhamni	Citroenvlinder
Gonepteryx farinosa	Bestoven citroenvlinder
Gonepteryx cleopatra	Cleopatra
Hamearis lucina	Sleutelbloemvlinder
Cigaritis acamas	Oostelijke zilverstreep
Lycaena phlaeas	Kleine vuurvlinder
Lycaena helle	Blauwe vuurvlinder
Lycaena dispar	Grote vuurvlinder
Lycaena virgaureae	Morgenrood
Lycaena ottomanus	Griekse vuurvlinder
Lycaena tityrus	Bruine vuurvlinder
Lycaena alciphron	Violette vuurvlinder
Lycaena hippothoe	Rode vuurvlinder
Lycaena candens	Balkanvuurvlinder
Lycaena thersamon	Oostelijke vuurvlinder
Lycaena thetis	Felle vuurvlinder
Thecla betulae	Sleedoornpage
Neozephyrus quercus	Eikenpage
Laeosopis roboris	Essenpage
Tomares ballus	Groene klaverpage
Tomares nogelii	Roemeense klaverpage
Callophrys rubi	Groentje
Callophrys avis	Aardbeiboomgroentje
Satyrium w-album	Iepenpage
Satyrium pruni	Pruimenpage
Satyrium spini	Wegedoornpage
Satyrium ilicis	Bruine eikenpage
Satyrium esculi	Spaanse eikenpage
Satyrium acaciae	Kleine sleedoornpage
Satyrium ledereri	Duizendknooppage
Lampides boeticus	Tijgerblauwtje
Cacyreus marshalli	Geraniumblauwtje
Leptotes pirithous	Klein tijgerblauwtje
Tarucus theophrastus	Moors christusdoornblauwtje
Tarucus balkanica	Klein christusdoornblauwtje
Zizeeria knysna	Amethistblauwtje
Cupido minimus	Dwergblauwtje
Cupido osiris	Zuidelijk dwergblauwtje
Cupido lorquinii	Moors dwergblauwtje
Cupido argiades	Staartblauwtje
Cupido decolorata	Oostelijk staartblauwtje
Cupido alcetas	Zuidelijk staartblauwtje
Celastrina argiolus	Boomblauwtje
Pseudophilotes baton	Klein tijmblauwtje
Pseudophilotes vicrama	Oostelijk tijmblauwtje
Pseudophilotes abencerragus	Moors tijmblauwtje
Pseudophilotes barbagiae	Sardijns tijmblauwtje
Pseudophilotes bavius	Salieblauwtje
Scolitantides orion	Vetkruidblauwtje
Glaucopsyche alexis	Bloemenblauwtje
Glaucopsyche paphos	Cypriotisch bloemenblauwtje
Glaucopsyche melanops	Spaans bloemenblauwtje
Iolana iolas	Blazenstruikblauwtje
Maculinea arion	Tijmblauwtje
Maculinea teleius	Pimpernelblauwtje
Maculinea nausithous	Donker pimpernelblauwtje
Maculinea alcon	Gentiaanblauwtje
Maculinea rebeli	Berggentiaanblauwtje
Lachides galba	Acaciablauwtje
Turanana endymion	Loodkruidblauwtje
Chilades trochylus	Heliotroopblauwtje
Plebeius pylaon	Oostelijk saffierblauwtje
Plebeius trappi	Alpensaffierblauwtje
Plebeius hesperica	Spaans saffierblauwtje
Plebeius argus	Heideblauwtje
Plebeius idas	Vals heideblauwtje
Plebeius argyrognomon	Kroonkruidblauwtje
Plebeius optilete	Veenbesblauwtje
Plebeius loewii	Azuurblauwtje
Plebeius eurypilus	Tragantblauwtje
Plebeius psylorita	Kretablauwtje
Plebeius pyrenaica	Zuidelijk mansschildblauwtje
Plebeius glandon	Noordelijk mansschildblauwtje
Plebeius orbitulus	Alpenblauwtje
Aricia eumedon	Zwart blauwtje
Aricia cramera	Moors bruin blauwtje
Aricia agestis	Bruin blauwtje
Aricia artaxerxes	Vals bruin blauwtje
Aricia morronensis	Spaans bruin blauwtje
Aricia anteros	Balkan bruin blauwtje
Aricia nicias	Zilverbruin blauwtje
Polyommatus semiargus	Klaverblauwtje
Polyommatus coelestina	Kobaltblauwtje
Polyommatus escheri	Groot tragantblauwtje
Polyommatus dorylas	Turkooisblauwtje
Polyommatus golgus	Nevadaturkooisblauwtje
Polyommatus nivescens	Parelmoerblauwtje
Polyommatus amandus	Wikkeblauwtje
Polyommatus thersites	Esparcetteblauwtje
Polyommatus icarus	Icarusblauwtje
Polyommatus andronicus	Grieks icarusblauwtje
Polyommatus eroides	Bremblauwtje
Polyommatus eros	Vlaggewikkeblauwtje
Polyommatus menelaos	Taygetosblauwtje
Polyommatus daphnis	Getand blauwtje
Polyommatus bellargus	Adonisblauwtje
Polyommatus coridon	Bleek blauwtje
Polyommatus caelestissima	Spaans bleek blauwtje
Polyommatus philippi	Macedonisch bleek blauwtje
Polyommatus hispana	Proven√ßaals bleek blauwtje
Polyommatus albicans	Kwartsblauwtje
Polyommatus admetus	Oostelijk esparcetteblauwtje
Polyommatus fabressei	Spaans esparcetteblauwtje
Polyommatus humedasae	Aosta-esparcetteblauwtje
Polyommatus ripartii	Zuidelijk esparcetteblauwtje
Polyommatus galloi	Calabrisch esparcetteblauwtje
Polyommatus aroaniensis	Grieks esparcetteblauwtje
Polyommatus nephohiptamenos	Macedonisch esparcetteblauwtje
Polyommatus virgilia	Italiaans zilverblauwtje
Polyommatus dolus	Frans vachtblauwtje
Polyommatus fulgens	Catalaans vachtblauwtje
Polyommatus iphigenia	Turks witstreepblauwtje
Polyommatus damon	Witstreepblauwtje
Libythea celtis	Snuitvlinder
Argynnis paphia	Keizersmantel
Argynnis pandora	Kardinaalsmantel (Pandora)
Argynnis aglaja	Grote parelmoervlinder
Argynnis adippe	Adippevlinder
Argynnis niobe	Duinparelmoervlinder
Argynnis elisa	Corsicaanse parelmoervlinder
Argynnis laodice	Tsarenmantel
Issoria lathonia	Kleine parelmoervlinder
Brenthis ino	Purperstreepparelmoervlinder
Brenthis daphne	Braamparelmoervlinder
Brenthis hecate	Dubbelstipparelmoervlinder
Boloria eunomia	Ringoogparelmoervlinder
Boloria euphrosyne	Zilvervlek
Boloria titania	Titania's parelmoervlinder
Boloria selene	Zilveren maan
Boloria chariclea	Arctische parelmoervlinder
Boloria freija	Freija's parelmoervlinder
Boloria dia	Akkerparelmoervlinder
Boloria polaris	Poolparelmoervlinder
Boloria thore	Thor's parelmoervlinder
Boloria frigga	Frigga's parelmoervlinder
Boloria improba	Donkere parelmoervlinder
Boloria pales	Herdersparelmoervlinder
Boloria napaea	Bergparelmoervlinder
Boloria aquilonaris	Veenbesparelmoervlinder
Boloria graeca	Balkanparelmoervlinder
Vanessa atalanta	Atalanta
Vanessa cardui	Distelvlinder
Inachis io	Dagpauwoog
Aglais urticae	Kleine vos
Polygonia c-album	Gehakkelde aurelia
Polygonia egea	Zuidelijke aurelia
Araschnia levana	Landkaartje
Nymphalis antiopa	Rouwmantel
Nymphalis polychloros	Grote vos
Nymphalis xanthomelas	Oostelijke vos
Nymphalis vaualbum	Gehakkelde vos
Euphydryas iduna	Geelbonte parelmoervlinder
Euphydryas cynthia	Witbonte parelmoervlinder
Euphydryas intermedia	Oranjebonte parelmoervlinder
Euphydryas maturna	Roodbonte parelmoervlinder
Euphydryas desfontainii	Mozaiekparelmoervlinder
Euphydryas aurinia	Moerasparelmoervlinder
Melitaea cinxia	Veldparelmoervlinder
Melitaea phoebe	Knoopkruidparelmoervlinder
Melitaea aetherie	Moorse parelmoervlinder
Melitaea arduinna	Centaurieparelmoervlinder
Melitaea trivia	Toortsparelmoervlinder
Melitaea didyma	Tweekleurige parelmoervlinder
Melitaea diamina	Woudparelmoervlinder
Melitaea deione	Spaanse parelmoervlinder
Melitaea varia	Alpenparelmoervlinder
Melitaea parthenoides	Westelijke parelmoervlinder
Melitaea aurelia	Steppeparelmoervlinder
Melitaea britomartis	Oostelijke parelmoervlinder
Melitaea asteria	Dwergparelmoervlinder
Melitaea athalia	Bosparelmoervlinder
Limenitis populi	Grote ijsvogelvlinder
Limenitis camilla	Kleine ijsvogelvlinder
Limenitis reducta	Blauwe ijsvogelvlinder
Neptis sappho	Lathyruszwever
Neptis rivularis	Spireazwever
Charaxes jasius	Pasja
Apatura metis	Oostelijke weerschijnvlinder
Apatura ilia	Kleine weerschijnvlinder
Apatura iris	Grote weerschijnvlinder
Kirinia roxelana	Grote schaduwzandoog
Esperarge climene	Kleine schaduwzandoog
Pararge aegeria	Bont zandoogje
Lasiommata megera	Argusvlinder
Lasiommata paramegaera	Vale argusvlinder
Lasiommata petropolitana	Kleine rotsvlinder
Lasiommata maera	Rotsvlinder
Lopinga achine	Boszandoog
Ypthima asterope	Dubbeloog
Coenonympha tullia	Veenhooibeestje
Coenonympha oedippus	Goudooghooibeestje
Coenonympha rhodopensis	Balkanhooibeestje
Coenonympha arcania	Tweekleurig hooibeestje
Coenonympha glycerion	Roodstreephooibeestje
Coenonympha gardetta	Alpenhooibeestje
Coenonympha darwiniana	Darwin's hooibeestje
Coenonympha corinna	Corsicaans hooibeestje
Coenonympha elbana	Elbahooibeestje
Coenonympha dorus	Bleek hooibeestje
Coenonympha hero	Zilverstreephooibeestje
Coenonympha leander	Turks hooibeestje
Coenonympha pamphilus	Hooibeestje
Coenonympha thyrsis	Kretahooibeestje
Pyronia tithonus	Oranje zandoogje
Pyronia cecilia	Zuidelijk oranje zandoogje
Pyronia bathseba	Spaans oranje zandoogje
Aphantopus hyperantus	Koevinkje
Maniola telmessia	Levant bruin zandoogje
Maniola cypricola	Cypriotisch bruin zandoogje
Maniola halicarnassus	Ege√Øsch bruin zandoogje
Maniola nurag	Sardijns bruin zandoogje
Maniola chia	Chios bruin zandoogje
Maniola jurtina	Bruin zandoogje
Maniola megala	Turks bruin zandoogje
Hyponephele lycaon	Grauw zandoogje
Hyponephele lupinus	Zuidelijk grauw zandoogje
Proterebia afra	Veeloog
Erebia ligea	Boserebia
Erebia euryale	Grote erebia
Erebia eriphyle	Alpenbergerebia
Erebia manto	Geelvlekbergerebia
Erebia claudina	Parelsnoerbergerebia
Erebia flavofasciata	Geelbandbergerebia
Erebia epiphron	Bergerebia
Erebia orientalis	Bulgaarse bergerebia
Erebia christi	Simplonbergerebia
Erebia pharte	Blinde bergerebia
Erebia melampus	Kleine bergerebia
Erebia sudetica	Karpatenbergerebia
Erebia aethiops	Zomererebia
Erebia triaria	Zuidelijke erebia
Erebia embla	Siberische erebia
Erebia disa	Noordse erebia
Erebia medusa	Voorjaarserebia
Erebia polaris	Poolerebia
Erebia alberganus	Amandeloogerebia
Erebia pluto	Roeterebia
Erebia gorge	Gewone zijde-erebia
Erebia rhodopensis	Balkanzijde-erebia
Erebia aethiopella	Cottische zijde-erebia
Erebia mnestra	Alpenzijde-erebia
Erebia gorgone	Pyrenee√´nzijde-erebia
Erebia epistygne	Lente-erebia
Erebia ottomana	Oostelijke glanserebia
Erebia tyndarus	Zwitserse glanserebia
Erebia nivalis	Alpenglanserebia
Erebia calcaria	Julische glanserebia
Erebia cassioides	Gewone glanserebia
Erebia hispania	Spaanse glanserebia
Erebia pronoe	Watererebia
Erebia lefebvrei	Cantabrische erebia
Erebia scipio	Proven√ßaalse erebia
Erebia stirius	Karinthische erebia
Erebia styx	Oostenrijkse erebia
Erebia montana	Marmererebia
Erebia zapateri	Castiliaanse erebia
Erebia neoridas	Herfsterebia
Erebia melas	Zwarte erebia
Erebia oeme	Bontoogerebia
Erebia meolans	Donkere erebia
Erebia palarica	Asturische erebia
Erebia pandrose	Gewone dauwerebia
Erebia sthennyo	Pyrenee√´ndauwerebia
Melanargia russiae	Zuidelijk dambordje
Melanargia galathea	Dambordje
Melanargia lachesis	Spaans dambordje
Melanargia larissa	Oostelijk dambordje
Melanargia arge	Italiaans dambordje
Melanargia occitanica	Westelijk dambordje
Melanargia pherusia	Siciliaans dambordje
Melanargia ines	Moors dambordje
Satyrus ferula	Grote saterzandoog
Satyrus actaea	Kleine saterzandoog
Minois dryas	Blauwoogvlinder
Hipparchia fagi	Grote boswachter
Hipparchia alcyone	Kleine boswachter
Hipparchia syriaca	Balkanboswachter
Hipparchia neomiris	Corsicaanse heivlinder
Hipparchia aristaeus	Zuidelijke heivlinder
Hipparchia cretica	Kretaheivlinder
Hipparchia semele	Heivlinder
Hipparchia mersina	Ege√Øsche heivlinder
Hipparchia volgensis	Balkanheivlinder
Hipparchia christenseni	Karpathosheivlinder
Hipparchia pellucida	Turkse heivlinder
Hipparchia statilinus	Kleine heivlinder
Hipparchia fatua	Donkere heivlinder
Hipparchia fidia	Gestreepte heivlinder
Arethusana arethusa	Oranje steppevlinder
Brintesia circe	Witbandzandoog
Chazara briseis	Heremiet
Chazara prieuri	Bonte heremiet
Pseudochazara geyeri	Grauwe heremiet
Pseudochazara graeca	Griekse heremiet
Pseudochazara amymone	Ioannina heremiet
Pseudochazara orestes	Bulgaarse heremiet
Pseudochazara hippolyte	Nevadaheremiet
Pseudochazara mniszechii	Roodbandheremiet
Pseudochazara cingovskii	Macedonische heremiet
Pseudochazara anthelea	Witbandheremiet
Oeneis norna	Noordse toendravlinder
Oeneis bore	Pooltoendravlinder
Oeneis glacialis	Gletsjervlinder
Oeneis jutta	Baltische toendravlinder
Danaus plexippus	Monarchvlinder
Danaus chrysippus	Kleine monarchvlinder